空空空空空空空空空空空空空
空砖空砖空砖空砖空砖空砖空
空砖空砖空砖空砖空砖空砖空
空砖空砖空砖空砖空砖空砖空
空砖空砖空砖空砖空砖空砖空
铁空草空草空草空草空草空铁
空空空空空空空空空空空空空
水水水水水水水水水水水水水
空空空空空空空空空空空空空
空空空空空空空空空空空空空
空空空空空空空空空空空空空
空空空空空空空空空空空空空